11111111111111111111
1E0100000000000C0001
101P11010010000M1011
10100100001010100011
10000001C10C000M1C01
11111111111111111111
